BotCommandScopeAllChatAdministrators: 'type' is not in __init__() and 'type' default value is: DEFAULT_BOT_COMMAND_SCOPE_ALL_CHAT_ADMINISTRATORS
BotCommandScopeAllGroupChats: 'type' is not in __init__() and 'type' default value is: DEFAULT_BOT_COMMAND_SCOPE_ALL_GROUP_CHATS
BotCommandScopeAllPrivateChats: 'type' is not in __init__() and 'type' default value is: DEFAULT_BOT_COMMAND_SCOPE_ALL_PRIVATE_CHATS
BotCommandScopeChat: 'type' is not in __init__() and 'type' default value is: DEFAULT_BOT_COMMAND_SCOPE_CHAT
BotCommandScopeChatAdministrators: 'type' is not in __init__() and 'type' default value is: DEFAULT_BOT_COMMAND_SCOPE_CHAT_ADMINISTRATORS
BotCommandScopeChatMember: 'type' is not in __init__() and 'type' default value is: DEFAULT_BOT_COMMAND_SCOPE_CHAT_MEMBER
BotCommandScopeDefault: 'type' is not in __init__() and 'type' default value is: DEFAULT_BOT_COMMAND_SCOPE_DEFAULT
ChatBoostSourceGiftCode: 'source' is not in __init__() and 'source' default value is: DEFAULT_CHAT_BOOST_SOURCE_GIFT_CODE
ChatBoostSourceGiveaway: 'source' is not in __init__() and 'source' default value is: DEFAULT_CHAT_BOOST_SOURCE_GIVEAWAY
ChatBoostSourcePremium: 'source' is not in __init__() and 'source' default value is: DEFAULT_CHAT_BOOST_SOURCE_PREMIUM
ChatMemberAdministrator: 'status' is not in __init__() and 'status' default value is: DEFAULT_CHAT_MEMBER_ADMINISTRATOR
ChatMemberBanned: 'status' is not in __init__() and 'status' default value is: DEFAULT_CHAT_MEMBER_BANNED
ChatMemberLeft: 'status' is not in __init__() and 'status' default value is: DEFAULT_CHAT_MEMBER_LEFT
ChatMemberMember: 'status' is not in __init__() and 'status' default value is: DEFAULT_CHAT_MEMBER_MEMBER
ChatMemberOwner: 'status' is not in __init__() and 'status' default value is: DEFAULT_CHAT_MEMBER_OWNER
ChatMemberRestricted: 'status' is not in __init__() and 'status' default value is: DEFAULT_CHAT_MEMBER_RESTRICTED
ForceReply: 'force_reply: Literal[True]' is not in __init__() and 'force_reply: Literal[True]' default value is: True
InlineKeyboardMarkup: 'inline_keyboard' default value is: inline_keyboard or []
InlineQueryResultArticle: 'type' is not in __init__() and 'type' default value is: DEFAULT_INLINE_QUERY_RESULT_ARTICLE
InlineQueryResultAudio: 'type' is not in __init__() and 'type' default value is: DEFAULT_INLINE_QUERY_RESULT_AUDIO
InlineQueryResultCachedAudio: 'type' is not in __init__() and 'type' default value is: DEFAULT_INLINE_QUERY_RESULT_CACHED_AUDIO
InlineQueryResultCachedDocument: 'type' is not in __init__() and 'type' default value is: DEFAULT_INLINE_QUERY_RESULT_CACHED_DOCUMENT
InlineQueryResultCachedGif: 'type' is not in __init__() and 'type' default value is: DEFAULT_INLINE_QUERY_RESULT_CACHED_GIF
InlineQueryResultCachedMpeg4Gif: 'type' is not in __init__() and 'type' default value is: DEFAULT_INLINE_QUERY_RESULT_CACHED_MPEG4_GIF
InlineQueryResultCachedPhoto: 'type' is not in __init__() and 'type' default value is: DEFAULT_INLINE_QUERY_RESULT_CACHED_PHOTO
InlineQueryResultCachedSticker: 'type' is not in __init__() and 'type' default value is: DEFAULT_INLINE_QUERY_RESULT_CACHED_STICKER
InlineQueryResultCachedVideo: 'type' is not in __init__() and 'type' default value is: DEFAULT_INLINE_QUERY_RESULT_CACHED_VIDEO
InlineQueryResultCachedVoice: 'type' is not in __init__() and 'type' default value is: DEFAULT_INLINE_QUERY_RESULT_CACHED_VOICE
InlineQueryResultContact: 'type' is not in __init__() and 'type' default value is: DEFAULT_INLINE_QUERY_RESULT_CONTACT
InlineQueryResultDocument: 'type' is not in __init__() and 'type' default value is: DEFAULT_INLINE_QUERY_RESULT_DOCUMENT
InlineQueryResultGame: 'type' is not in __init__() and 'type' default value is: DEFAULT_INLINE_QUERY_RESULT_GAME
InlineQueryResultGif: 'type' is not in __init__() and 'type' default value is: DEFAULT_INLINE_QUERY_RESULT_GIF
InlineQueryResultLocation: 'type' is not in __init__() and 'type' default value is: DEFAULT_INLINE_QUERY_RESULT_LOCATION
InlineQueryResultMpeg4Gif: 'type' is not in __init__() and 'type' default value is: DEFAULT_INLINE_QUERY_RESULT_MPEG4_GIF
InlineQueryResultPhoto: 'type' is not in __init__() and 'type' default value is: DEFAULT_INLINE_QUERY_RESULT_PHOTO
InlineQueryResultVenue: 'type' is not in __init__() and 'type' default value is: DEFAULT_INLINE_QUERY_RESULT_VENUE
InlineQueryResultVideo: 'type' is not in __init__() and 'type' default value is: DEFAULT_INLINE_QUERY_RESULT_VIDEO
InlineQueryResultVoice: 'type' is not in __init__() and 'type' default value is: DEFAULT_INLINE_QUERY_RESULT_VOICE
InputFile: Not found InputFile.file_name and Not found InputFile.hide_name
Message: 'text' default value is: text or str() # If not text, it's str() instead of None
ReactionTypeEmoji: 'type' is not in __init__() and 'type' default value is: DEFAULT_REACTION_TYPE_EMOJI
ReactionTypeCustomEmoji: 'type' is not in __init__() and 'type' default value is: DEFAULT_REACTION_TYPE_CUSTOM_EMOJI
ReplyKeyboardMarkup: 'keyboard' default value is: keyboard or []
ReplyKeyboardRemove: 'remove_keyboard: Literal[True]' is not in __init__() and 'remove_keyboard: Literal[True]' default value is: True
MenuButtonCommands: 'type' is not in __init__() and 'type' default value is: DEFAULT_MENU_BUTTON_COMMANDS
MenuButtonWebApp: 'type' is not in __init__() and 'type' default value is: DEFAULT_MENU_BUTTON_WEB_APP
MenuButtonDefault: 'type' is not in __init__() and 'type' default value is: DEFAULT_MENU_BUTTON_DEFAULT
InputMediaPhoto: 'type' is not in __init__() and 'type' default value is: DEFAULT_INPUT_MEDIA_PHOTO
InputMediaVideo: 'type' is not in __init__() and 'type' default value is: DEFAULT_INPUT_MEDIA_VIDEO
InputMediaAnimation: 'type' is not in __init__() and 'type' default value is: DEFAULT_INPUT_MEDIA_ANIMATION
InputMediaAudio: 'type' is not in __init__() and 'type' default value is: DEFAULT_INPUT_MEDIA_AUDIO
InputMediaDocument: 'type' is not in __init__() and 'type' default value is: DEFAULT_INPUT_MEDIA_DOCUMENT
PassportElementErrorDataField: 'source' is not in __init__() and 'source' default value is: DEFAULT_PASSPORT_ELEMENT_ERROR_DATA_FIELD
PassportElementErrorFrontSide: 'source' is not in __init__() and 'source' default value is: DEFAULT_PASSPORT_ELEMENT_ERROR_FRONT_SIDE
PassportElementErrorReverseSide: 'source' is not in __init__() and 'source' default value is: DEFAULT_PASSPORT_ELEMENT_ERROR_REVERSE_SIDE
PassportElementErrorSelfie: 'source' is not in __init__() and 'source' default value is: DEFAULT_PASSPORT_ELEMENT_ERROR_SELFIE
PassportElementErrorFile: 'source' is not in __init__() and 'source' default value is: DEFAULT_PASSPORT_ELEMENT_ERROR_FILE
PassportElementErrorFiles: 'source' is not in __init__() and 'source' default value is: DEFAULT_PASSPORT_ELEMENT_ERROR_FILES
PassportElementErrorTranslationFile: 'source' is not in __init__() and 'source' default value is: DEFAULT_PASSPORT_ELEMENT_ERROR_TRANSLATION_FILE
PassportElementErrorTranslationFiles: 'source' is not in __init__() and 'source' default value is: DEFAULT_PASSPORT_ELEMENT_ERROR_TRANSLATION_FILES
PassportElementErrorUnspecified: 'source' is not in __init__() and 'source' default value is: DEFAULT_PASSPORT_ELEMENT_ERROR_UNSPECIFIED
MessageOriginUser: 'type' is not in __init__() and 'type' default value is: DEFAULT_MESSAGE_ORIGIN_USER
MessageOriginHiddenUser: 'type' is not in __init__() and 'type' default value is: DEFAULT_MESSAGE_ORIGIN_HIDDEN_USER
MessageOriginChat: 'type' is not in __init__() and 'type' default value is: DEFAULT_MESSAGE_ORIGIN_CHAT
MessageOriginChannel: 'type' is not in __init__() and 'type' default value is: DEFAULT_MESSAGE_ORIGIN_CHANNEL